Tile_Scale: 100
Map_Width_In_Tiles: 40
Map_Height_In_Tiles: 40

01 01 01 01 02 02 02 02 02 02 02 02 02 02 02 02 02 02 02 02 02 02 02 02 02 02 02 02 02 02 02 02 02 02 02 02 02 02 02 02
01 01 01 01 01 01 01 01 01 02 01 01 02 01 01 01 01 01 02 01 01 01 01 01 01 01 01 01 01 01 02 01 01 02 01 01 01 01 01 02
02 02 02 02 01 01 02 02 02 02 01 01 02 01 01 02 02 02 02 02 02 02 02 02 02 01 01 02 02 02 02 01 01 02 01 01 02 01 01 02
02 01 01 01 01 01 02 01 01 01 01 01 02 01 01 02 01 01 02 01 01 02 01 01 02 01 01 01 01 01 01 01 01 02 01 01 02 01 01 02
02 01 01 02 01 01 02 01 01 02 02 02 02 01 01 02 01 01 02 01 01 02 01 01 02 02 02 02 01 01 02 01 01 02 02 02 02 01 01 02
02 01 01 02 01 01 02 01 01 01 01 01 01 01 01 01 01 01 01 01 01 01 01 01 02 01 01 01 01 01 02 01 01 01 01 01 01 01 01 02
02 02 02 02 01 01 02 01 01 02 02 02 02 01 01 02 01 01 02 01 01 02 02 02 02 01 01 02 01 01 02 02 02 02 02 02 02 01 01 02
02 01 01 01 01 01 02 01 01 01 01 01 02 01 01 02 01 01 02 01 01 01 01 01 02 01 01 02 01 01 02 01 01 02 01 01 01 01 01 02
02 01 01 02 02 02 02 02 02 02 01 01 02 02 02 02 02 02 02 02 02 02 01 01 02 01 01 02 02 02 02 01 01 02 01 01 02 01 01 02
02 01 01 02 01 01 02 01 01 02 01 01 02 01 01 02 01 01 01 01 01 01 01 01 01 01 01 02 01 01 01 01 01 01 01 01 02 01 01 02
02 01 01 02 01 01 02 01 01 02 01 01 02 01 01 02 01 01 02 02 02 02 01 01 02 02 02 02 02 02 02 01 01 02 01 01 02 01 01 02
02 01 01 01 01 01 02 01 01 01 01 01 01 01 01 02 01 01 01 01 01 02 01 01 01 01 01 01 01 01 01 01 01 02 01 01 02 01 01 02
02 01 01 02 01 01 02 02 02 02 02 02 02 02 02 02 01 01 02 02 02 02 02 02 01 02 02 02 02 02 02 02 02 02 01 01 02 02 02 02
02 01 01 02 01 01 02 01 01 01 01 01 02 01 01 02 01 01 01 01 01 01 01 01 02 01 01 01 01 01 02 01 01 02 01 01 02 01 01 02
02 01 01 02 01 01 02 01 01 02 02 02 02 01 01 02 01 01 01 01 01 01 01 01 02 01 01 02 02 02 02 01 01 02 01 01 02 01 01 02
02 01 01 02 01 01 01 01 01 02 01 01 01 01 01 01 01 01 01 01 01 01 01 01 02 01 01 02 01 01 02 01 01 02 01 01 01 01 01 02
02 02 02 02 01 01 02 01 01 02 02 02 02 01 01 01 01 01 01 01 01 01 01 01 02 01 01 02 01 01 02 01 01 02 02 02 02 01 01 02
02 01 01 02 01 01 02 01 01 01 01 01 01 01 01 01 01 01 01 01 01 01 01 01 01 01 01 01 01 01 02 01 01 01 01 01 02 01 01 02
02 01 01 02 02 02 02 01 01 02 01 01 02 02 02 02 01 01 01 01 01 01 01 01 02 02 02 02 02 02 02 02 02 02 01 01 02 01 01 02
02 01 01 01 01 01 01 01 01 02 01 01 02 01 01 01 01 01 01 01 01 01 01 01 02 01 01 01 01 01 01 01 01 01 01 01 02 01 01 02
02 01 01 02 02 02 02 01 01 02 02 02 02 02 02 02 01 01 02 01 01 02 02 02 02 02 02 02 01 01 02 02 02 02 02 02 02 01 01 02
02 01 01 02 01 01 01 01 01 02 01 01 02 01 01 01 01 01 02 01 01 01 01 01 01 01 01 01 01 01 02 01 01 01 01 01 01 01 01 02
02 01 01 02 02 02 02 01 01 02 01 01 02 01 01 02 01 01 02 01 01 02 01 01 02 02 02 02 01 01 02 02 02 02 01 01 02 02 02 02
02 01 01 02 01 01 01 01 01 01 01 01 02 01 01 02 01 01 02 01 01 02 01 01 02 01 01 02 01 01 01 01 01 02 01 01 01 01 01 02
02 02 02 02 02 02 02 02 02 02 01 01 02 02 02 02 01 01 02 01 01 02 02 02 02 01 01 02 02 02 02 01 01 02 01 01 02 01 01 02
02 01 01 01 01 01 01 01 01 01 01 01 01 01 01 01 01 01 01 01 01 01 01 01 01 01 01 01 01 01 01 01 01 01 01 01 02 01 01 01
02 01 01 02 02 02 02 02 02 02 02 02 02 02 02 02 02 02 02 02 02 02 02 02 02 02 02 02 02 02 02 02 02 02 02 02 02 01 01 01
01 01 01 02 02 02 02 02 02 02 02 02 02 02 02 02 02 02 02 02 02 02 02 02 02 02 02 02 02 02 02 02 02 02 02 02 02 02 02 02
01 01 01 01 01 01 01 01 01 01 01 01 02 01 01 01 01 01 02 01 01 01 01 01 01 01 01 01 01 01 02 01 01 02 01 01 01 01 01 02
02 02 02 02 01 01 02 02 02 02 01 01 02 01 01 02 02 02 02 02 02 02 02 02 02 01 01 02 02 02 02 01 01 02 01 01 02 01 01 02
02 01 01 01 01 01 02 01 01 01 01 01 02 01 01 02 01 01 02 01 01 02 01 01 02 01 01 01 01 01 01 01 01 02 01 01 02 01 01 02
02 01 01 02 01 01 02 01 01 02 02 02 02 01 01 02 01 01 02 01 01 02 01 01 02 02 02 02 01 01 02 01 01 02 02 02 02 01 01 02
02 01 01 02 01 01 02 01 01 01 01 01 01 01 01 01 01 01 01 01 01 01 01 01 02 01 01 01 01 01 02 01 01 01 01 01 01 01 01 02
02 02 02 02 01 01 02 01 01 02 02 02 02 01 01 02 01 01 02 01 01 02 02 02 02 01 01 02 01 01 02 02 02 02 02 02 02 01 01 02
02 01 01 01 01 01 02 01 01 01 01 01 02 01 01 02 01 01 02 01 01 01 01 01 02 01 01 02 01 01 02 02 02 02 01 01 01 01 01 02
02 01 01 02 02 02 02 02 02 02 01 01 02 02 02 02 02 02 02 02 02 02 01 01 02 01 01 02 02 02 02 02 02 02 01 01 02 01 01 02
02 01 01 02 01 01 02 01 01 02 01 01 02 01 01 02 01 01 01 01 01 02 01 01 01 01 01 02 01 01 01 01 01 01 01 01 02 01 01 02
02 01 01 02 01 01 02 01 01 02 01 01 02 01 01 02 01 01 02 02 02 02 01 01 02 02 02 02 01 01 01 01 01 02 01 01 02 01 01 02
02 01 01 01 01 01 02 01 01 01 01 01 01 01 01 02 01 01 01 01 01 02 01 01 01 01 01 02 01 01 01 01 01 02 01 02 02 01 01 02
02 01 01 02 01 01 02 02 02 02 02 02 02 02 02 02 01 01 02 02 02 02 02 02 02 02 02 02 01 01 01 01 01 02 01 02 02 02 02 02

